.........#
.c.....e.#
.........#
.........#
.s.....w.#
.........#
.........#
.v.....q.#
.........#
##########