.........#
.c.....q.#
.........#
.........#
.s.....w.#
.........#
.........#
.v.....e.#
.........#
##########